#################
#....#...#....#.#
#.#..#.#.#....#.#
#.#..#.#.#....#.#
#......#.####.#.#
#.#..#..........#
#################