....#....##.#.....#....##.#....#....##.#.....#....##.#   
......####..#.......####..#......####..#.......####..#
#..#.....#..#.#..#.....#..##..#.....#..#.#..#.....#..#
#...........#.#...........##...........#.#...........#
##.#####.###..##.#####.###.##.#####.###..##.#####.###.   
#...####.....##...####.....#...####.....##...####.....
.....###...........###..........###...........###.....
##.##....#....##.##....#...##.##....#....##.##....#...
....#....##.#.....#....##.#....#....##.#.....#....##.#  
..#.#....##.#.....#....##.#....#....##.#.....#....##.#
......####..#.......####..#......####..#.......####..#
#..#.....#..#.#..#.....#..##..#.....#..#.#..#.....#..#
#...........#.#...........##...........#.#...........#
##.#####.###..##.#####.###.##.#####.###..##.#####.###.
#...####.....##...####.....#...####.....##...####.....
.....###...........###..........###...........###.....
####.....#....##.##....#...##.##....#....##.##....#...
....#....##.#.....#....##.#....#....##.#.....#....##.#
....#....##.#.....#....##.#....#....##.#.....#....##.#
.#....####..#.......####..#......####..#.......####..#
#..#.....#..#.#..#.....#..##..#.....#..#.#..#.....#..#
#...........#.#...........##...........#.#...........#
#..#####.###..##.#####.###.##.#####.###..##.#####.###.
#.#.####.....##...####.....#...####.....##...####.....
.....###...........###..........###...........###.....
##.##....#....##.##....#...##.##....#....##.##....#...
     