#..#.....#..#.#..#.....#..##..#.....#..#.#..#.....#..#
#...........#.#...........##...........#.#...........#
##.#####.###..##.#####.###.##.#####.###..##.#####.###.
#...####.....##...####.....#...####.....##...####.....
.....###...........###..........###...........###.....
##.##....#....##.##....#...##.##....#....##.##....#...
....#....##.#.....#....##.#....#....##.#.....#....##.#
......####..#.......####..#......####..#.......####..#
#..#.....#..#.#..#.....#..##..#.....#..#.#..#.....#..#
#...........#.#...........##...........#.#...........#
##.#####.###..##.#####.###.##.#####.###..##.#####.###.
#...####.....##...####.....#...####.....##...####.....
.....###...........###..........###...........###.....
##.##....#....##.##....#...##.##....#....##.##....#...
....#....##.#.....#....##.#....#....##.#.....#....##.#
......####..#.......####..#......####..#.......####..#
#..#.....#..#.#..#.....#..##..#.....#..#.#..#.....#..#
#...........#.#...........##...........#.#...........#
##.#####.###..##.#####.###.##.#####.###..##.#####.###.
#...####.....##...####.....#...####.....##...####.....
.....###...........###..........###...........###.....
##.##....#....##.##....#...##.##....#....##.##....#...
....#....##.#.....#....##.#....#....##.#.....#....##.#
......####..#.......####..#......####..#.......####..#
#..#.....#..#.#..#.....#..##..#.....#..#.#..#.....#..#
#...........#.#...........##...........#.#...........#
##.#####.###..##.#####.###.##.#####.###..##.#####.###.
#...####.....##...####.....#...####.....##...####.....
.....###...........###..........###...........###.....
##.##....#....##.##....#...##.##....#....##.##....#...
....#....##.#.....#....##.#....#....##.#.....#....##.#
......####..#.......####..#......####..#.......####..#
#..#.....#..#.#..#.....#..##..#.....#..#.#..#.....#..#
#...........#.#...........##...........#.#...........#
##.#####.###..##.#####.###.##.#####.###..##.#####.###.
#...####.....##...####.....#...####.....##...####.....
.....###...........###..........###...........###.....
##.##....#....##.##....#...##.##....#....##.##....#...
....#....##.#.....#....##.#....#....##.#.....#....##.#
......####..#.......####..#......####..#.......####..#
#..#.....#..#.#..#.....#..##..#.....#..#.#..#.....#..#
#...........#.#...........##...........#.#...........#
##.#####.###..##.#####.###.##.#####.###..##.#####.###.
#...####.....##...####.....#...####.....##...####.....
.....###...........###..........###...........###.....
##.##....#....##.##....#...##.##....#....##.##....#...
....#....##.#.....#....##.#....#....##.#.....#....##.#
......####..#.......####..#......####..#.......####..#
#..#.....#..#.#..#.....#..##..#.....#..#.#..#.....#..#
#...........#.#...........##...........#.#...........#
##.#####.###..##.#####.###.##.#####.###..##.#####.###.
#...####.....##...####.....#...####.....##...####.....
.....###...........###..........###...........###.....
##.##....#....##.##....#...##.##....#....##.##....#...
....#....##.#.....#....##.#....#....##.#.....#....##.#
......####..#.......####..#......####..#.......####..#
#..#.....#..#.#..#.....#..##..#.....#..#.#..#.....#..#
#...........#.#...........##...........#.#...........#
##.#####.###..##.#####.###.##.#####.###..##.#####.###.
#...####.....##...####.....#...####.....##...####.....
.....###...........###..........###...........###.....
##.##....#....##.##....#...##.##....#....##.##....#...
....#....##.#.....#....##.#....#....##.#.....#....##.#
......####..#.......####..#......####..#.......####..#


