

1..1.....1..11..1.....1..11..1.....1..11..1.....1..1
2...........52...........52...........52...........5
22.66666.444.22.33333.444.22.33333.444.22.33333.444.
2...4444.....2...4444.....2...4444.....2...4444.....
.....224..........224..........224..........224.....
0000.....5...0000.....5...0000.....5...0000.....5...
1..1.....1..11..1.....1..11..1.....1..11..1.....1..1
2...........52...........52...........52...........5
22.33333.444.22.33333.444.22.33333.444.22.33333.444.
2...4444.....2...4444.....2...4444.....2...4444.....
.....224..........224..........224..........224.....
0000.....5...0000.....5...0000.....5...0000.....5...
1..1.....1..11..1.....1..11..1.....1..11..1.....1..1
2...........52...........52...........52...........5
22.33333.444.22.33333.444.22.33333.444.22.33333.444.
2...4444.....2...4444.....2...4444.....2...4444.....
.....224..........224..........224..........224.....
0000.....5...0000.....5...0000.....5...0000.....5...
1..1.....1..11..1.....1..11..1.....1..11..1.....1..1
2...........52...........52...........52...........5
22.33333.444.22.33333.444.22.33333.444.22.33333.444.
2...4444.....2...4444.....2...4444.....2...4444.....
.....224..........224..........224..........224.....
0000.....5...0000.....5...0000.....5...0000.....5...
 




                                               