#..#.....#..#.#..#.....#..#.#..#.....#..#.#..#.....#..#.
#...........#.#...........#.#...........#.#...........#.
##.#####.###..##.#####.###..##.#####.###..##.#####.###..
#...####.....##...####.....##...####.....##...####.....#
.....###...........###...........###...........###......
##.##....#....##.##....#....##.##....#....##.##....#....
....#....##.#.....#....##.#.....#....##.#.....#....##.#.
......####..#.......####..#.......####..#.......####..#.
#..#.....#..#.#..#.....#..#.#..#.....#..#.#..#.....#..#.
#...........#.#...........#.#...........#.#...........#.
##.#####.###..##.#####.###..##.#####.###..##.#####.###..
#...####.....##...####.....##...####.....##...####.....#
.....###...........###...........###...........###......
##.##....#....##.##....#....##.##....#....##.##....#....
....#....##.#.....#....##.#.....#....##.#.....#....##.#.
......####..#.......####..#.......####..#.......####..#.

#..#.....#..#.#..#.....#..#.#..#.....#..#.#..#.....#..#.
#...........#.#...........#.#...........#.#...........#.
##.#####.###..##.#####.###..##.#####.###..##.#####.###..
#...####.....##...####.....##...####.....##...####.....#
.....###...........###...........###...........###......
##.##....#....##.##....#....##.##....#....##.##....#....
....#....##.#.....#....##.#.....#....##.#.....#....##.#.
......####..#.......####..#.......####..#.......####..#.

#..#.....#..#.#..#.....#..#.#..#.....#..#.#..#.....#..#.
#...........#.#...........#.#...........#.#...........#.
##.#####.###..##.#####.###..##.#####.###..##.#####.###..
#...####.....##...####.....##...####.....##...####.....#
.....###...........###...........###...........###......
##.##....#....##.##....#....##.##....#....##.##....#....
....#....##.#.....#....##.#.....#....##.#.....#....##.#.
......####..#.......####..#.......####..#.......####..#.
